######################
##                   #
## ############# ### #
## ############# ### #
## ## ########## ### #
##         ##### ### #
## ## #### ##### ### #
## ## #### ##### ### #
## ## ####           #
## ## #### ######### #
## ## #### ######### #
#              ##### #
######################